1111111111111111111111111
1G1G1G1G111111111G1G1G1G1
11111111CCCCCCCCC11111111
1PCCCCCCCCCCCCCCCCCCCCCE1
10011111CCCCCCCCC11111111
1G1G1G1G111111111G1G1G1G1
1111111111111111111111111