1111111111111111111111111
1G1G1G1G111111111G1G1G1G1
1111111PCCCCCCCCC11111111
10CCCCC0CCCCCCCCCCCCCCC01
10011111CCCCCCCCC11111111
1G1G1G1G111111111G1G1G1G1
1111111111111111111111111